Province_State,Confirmed,Deaths,Recovered,Active,Last_Update,Lat,Long
Alabama,33206,896,0,32310,2020-06-26 04:33:43,32.88428035358209,-86.71012237686571
Alaska,813,12,0,801,2020-06-26 04:33:43,60.989186541578945,-145.31812686315791
Arizona,63281,1495,0,61786,2020-06-26 04:33:43,33.675903642,-111.46323212666667
Arkansas,18062,240,0,17822,2020-06-26 04:33:43,34.9302123831081,-92.43308954189189
California,201112,5806,0,195306,2020-06-26 04:33:43,37.778247709649115,-120.7286663122807
Colorado,31463,1669,0,29794,2020-06-26 04:33:43,38.93130682114752,-105.53290265081964
Connecticut,45994,4298,0,41696,2020-06-26 04:33:43,41.61368014,-72.65682967875
Delaware,10980,507,0,10473,2020-06-26 04:33:43,39.10927682333334,-75.53323745666665
Diamond Princess,49,0,0,49,2020-06-26 04:33:43,,
District of Columbia,10159,543,0,9616,2020-06-26 04:33:43,38.90417773,-77.01655992
Florida,114018,3327,0,110691,2020-06-26 04:33:43,28.94075487910448,-82.70074390925375
Georgia,71095,2745,0,68350,2020-06-26 04:33:43,32.80853214484278,-83.57742992610066
Grand Princess,103,3,0,100,2020-06-26 04:33:43,,
Guam,231,5,0,226,2020-06-26 04:33:43,13.4443,144.7937
Hawaii,851,17,0,834,2020-06-26 04:33:43,20.99064747,-157.41445579999998
Idaho,4865,90,0,4775,2020-06-26 04:33:43,44.23876033763159,-114.61309889210526
Illinois,139434,6810,0,132624,2020-06-26 04:33:43,39.84361770127451,-89.17833006960784
Indiana,43655,2586,0,41069,2020-06-26 04:33:43,39.83735316565217,-86.21856844913039
Iowa,27373,696,0,26677,2020-06-26 04:33:43,42.02991002353537,-93.46551942343434
Kansas,13107,262,0,12845,2020-06-26 04:33:43,38.44340571578946,-97.8750182128421
Kentucky,14617,546,0,14071,2020-06-26 04:33:43,37.61460527151261,-85.20954889075628
Louisiana,53415,3164,0,50251,2020-06-26 04:33:43,31.092427383437492,-91.82418665609377
Maine,3070,103,0,2967,2020-06-26 04:33:43,44.68768840625,-69.523768628125
Maryland,65777,3129,0,62648,2020-06-26 04:33:43,39.014920690416666,-76.67546760874998
Massachusetts,107837,7962,0,99875,2020-06-26 04:33:43,42.17639998153847,-71.57704993461539
Michigan,68989,6133,0,62856,2020-06-26 04:33:43,44.01164928353657,-85.13130273939028
Minnesota,34123,1441,0,32682,2020-06-26 04:33:43,45.55201297954022,-94.43095302689653
Mississippi,24516,1016,0,23500,2020-06-26 04:33:43,32.792726566585365,-89.64572580048781
Missouri,19637,987,0,18650,2020-06-26 04:33:43,38.456764881637945,-92.4994868846552
Montana,803,21,0,782,2020-06-26 04:33:43,46.838245747027024,-110.40738663513514
Nebraska,18346,260,0,18086,2020-06-26 04:33:43,41.321794947204275,-99.03901222387097
Nevada,14859,495,0,14364,2020-06-26 04:33:43,39.25599674470589,-117.5639935352941
New Hampshire,5638,357,0,5281,2020-06-26 04:33:43,43.478972876,-71.57765670500001
New Jersey,170196,14872,0,155324,2020-06-26 04:33:43,40.286440910952386,-74.62244971476191
New Mexico,11192,485,0,10707,2020-06-26 04:33:43,34.5036842278125,-105.91639915312498
New York,390415,31301,0,359114,2020-06-26 04:33:43,42.67159317862068,-75.57969394672415
North Carolina,57472,1336,0,56136,2020-06-26 04:33:43,35.62420971000002,-79.50109873960002
North Dakota,3393,78,0,3315,2020-06-26 04:33:43,47.44254295541668,-100.11784766416667
Northern Mariana Islands,30,2,0,28,2020-06-26 04:33:43,15.0979,145.6739
Ohio,47651,2772,0,44879,2020-06-26 04:33:43,40.310669812954565,-82.83540800659091
Oklahoma,11948,375,0,11573,2020-06-26 04:33:43,35.4994775475,-97.21922506644736
Oregon,7568,197,0,7371,2020-06-26 04:33:43,44.49240067472221,-121.47691959722222
Pennsylvania,88141,6557,0,81584,2020-06-26 04:33:43,40.81807835477611,-77.61531783850747
Puerto Rico,6877,151,0,6726,2020-06-26 04:33:43,18.2208,-66.5901
Recovered,0,0,663562,-663562,2020-06-26 04:33:43,,
Rhode Island,16640,920,0,15720,2020-06-26 04:33:43,41.655142106,-71.464105098
South Carolina,29022,693,0,28329,2020-06-26 04:33:43,33.957472131086966,-80.9833996921739
South Dakota,6479,87,0,6392,2020-06-26 04:33:43,44.19724764183332,-99.104857728
Tennessee,38034,567,0,37467,2020-06-26 04:33:43,35.88510221221052,-86.10872298863156
Texas,134558,2317,0,132241,2020-06-26 04:33:43,31.661642527991802,-98.56711516090158
Utah,19374,164,0,19210,2020-06-26 04:33:43,40.014400114615384,-111.46087804615384
Vermont,1191,56,0,1135,2020-06-26 04:33:43,44.159495798571434,-72.68438070571429
Virgin Islands,80,6,0,74,2020-06-26 04:33:43,18.3358,-64.8963
Virginia,59946,1675,0,58271,2020-06-26 04:33:43,37.56615032526316,-78.51371173503755
Washington,30367,1300,0,29067,2020-06-26 04:33:43,47.23378642,-120.71922041538465
West Virginia,2694,92,0,2602,2020-06-26 04:33:43,38.80580337592592,-80.61580153629627
Wisconsin,26227,766,0,25461,2020-06-26 04:33:43,44.395143494861124,-89.79797998097222
Wyoming,1326,20,0,1306,2020-06-26 04:33:43,43.086885505217396,-107.15324220434782
